           * 
   *   * * * 
   *       * 
   *   *   * 
   *   *   * 
 * * * * * * 
